.1##.##!.#
.##......#
.##.####.#
.#..!#...#
.#!###.###
....@....#
.###.....#
..#.#!.#!#
.!#.!#..4#
##########