.###......####.....#
.#!...##!..#!..##.!#
.#..####.#.#..#...##
..#.#.#.#....#..##5#
.#..##!!##..#..#...#
#..#.......#..##.!.#
..#..####!##!.!#!..#
2##.!###!@!#.......#
##..!####.##..!..#!#
##.!####...#..###..#
....#..!...###.....#
.!#.####...###.##.##
.....!##.......!...#
#.###.......##!##!.#
#.....##...##3.....#
####################